{
    "ground": [
        4,4,4,5,5,4,5,5,4,4,4,
        4,10,10,5,5,10,5,4,10,10,5,
        4,5,10,10,10,10,10,10,10,4,4,
        4,4,5,4,5,5,4,5,4,5,4,
        5,5,5,10,4,10,10,10,5,5,5,
        5,4,5,10,10,10,5,10,5,4,5,
        4,5,5,5,4,4,5,5,4,4,5,
        4,5,10,10,10,10,10,10,4,4,5,
        4,10,10,5,10,5,5,10,5,5,4,
        4,10,4,5,5,4,4,10,10,10,4,
        4,5,4,5,5,5,4,5,4,4,5
    ],
    "decoration": [
        0,0,0,307,303,0,0,302,301,0,0,
        0,605,605,315,0,605,309,0,605,605,0,
        0,317,605,605,605,605,605,605,605,0,0,
        0,0,303,0,301,303,0,307,0,0,0,
        315,0,313,605,0,605,605,605,0,318,0,
        309,0,0,605,605,605,317,605,313,0,314,
        0,318,0,302,0,0,303,303,0,0,315,
        0,307,605,605,605,605,605,605,0,0,0,
        0,605,605,317,605,0,315,605,309,0,0,
        0,605,0,0,302,0,0,605,605,605,0,
        0,0,0,302,311,307,0,302,0,0,0
    ],
    "cloud": [
        0,0,0,0,0,0,0,0,0,0,0,
        0,0,0,0,0,0,0,0,0,0,0,
        0,0,0,0,0,0,0,0,0,0,0,
        0,0,0,0,0,0,0,0,0,0,0,
        0,0,0,0,0,0,0,0,0,0,0,
        0,0,0,0,0,0,0,0,0,0,0,
        0,0,0,0,0,0,0,0,0,0,0,
        0,0,0,0,0,0,0,0,0,0,0,
        0,0,0,0,0,0,0,0,0,0,0,
        0,0,0,0,0,0,0,0,0,0,0,
        0,0,0,0,0,0,0,0,0,0,0
    ],
    "type": [
        0,0,0,0,0,0,0,0,0,0,0,
        0,1,1,0,0,1,0,0,1,1,0,
        0,0,1,1,1,1,1,1,1,0,0,
        0,0,0,0,0,0,0,0,0,0,0,
        0,0,0,1,0,1,1,1,0,0,0,
        0,0,0,1,1,1,0,1,0,0,0,
        0,0,0,0,0,0,0,0,0,0,0,
        0,0,1,1,1,1,1,1,0,0,0,
        0,1,1,0,1,0,0,1,0,0,0,
        0,1,0,0,0,0,0,1,1,1,0,
        0,0,0,0,0,0,0,0,0,0,0
    ],
    "team": [
        0,0,1,1,1,1,1,1,1,1,1,
        0,0,1,1,1,1,1,1,1,1,1,
        1,0,1,1,1,1,1,1,1,1,1,
        0,1,1,1,1,1,1,1,1,1,1,
        1,1,1,1,1,1,1,1,1,1,1,
        0,0,0,0,0,0,0,0,0,0,0,
        0,0,0,0,0,0,0,0,0,0,0,
        0,0,0,0,0,0,0,0,0,0,0,
        0,0,0,0,0,0,0,0,0,0,0,
        0,0,0,0,0,0,0,0,0,0,0,
        0,0,0,0,0,0,0,0,0,0,0
    ]
}