{
    "ground": [
        34,32,32,32,32,32,32,32,32,32,32,32,32,32,32,32,32,32,32,14,
        16,4,4,4,4,4,4,4,4,4,4,4,4,6,6,6,6,4,4,24,
        16,4,4,4,4,4,4,4,4,4,4,4,4,6,6,6,6,4,4,24,
        16,4,4,4,4,4,6,6,6,6,6,6,6,6,6,6,6,4,4,24,
        16,4,4,4,6,6,6,6,6,6,6,6,6,6,6,6,6,4,4,24,
        16,4,4,6,6,6,6,6,6,6,6,6,6,6,6,6,6,4,4,24,
        16,4,4,6,6,6,6,4,4,4,4,6,6,6,6,6,6,4,4,24,
        16,4,4,6,6,6,4,4,4,4,4,4,6,6,6,6,6,4,4,24,
        16,4,4,6,6,6,4,4,4,4,4,6,6,6,6,6,6,4,4,24,
        16,4,4,6,6,6,4,4,4,4,4,6,6,6,6,6,6,4,4,24,
        16,4,4,6,6,6,6,6,4,4,6,6,6,6,6,6,4,4,4,24,
        16,4,4,6,6,6,6,6,6,6,6,6,6,6,6,4,4,4,4,24,
        16,4,4,4,6,6,6,6,6,6,6,6,6,6,6,4,4,4,4,24,
        16,4,4,4,4,4,4,4,4,4,4,4,6,6,6,4,4,4,4,24,
        16,4,4,4,4,4,4,4,4,4,4,4,6,6,6,4,4,4,4,24,
        16,4,4,4,4,4,4,4,4,4,4,4,6,6,6,4,4,4,4,24,
        16,4,4,4,4,4,4,4,4,4,4,4,6,6,6,4,4,4,4,24,
        16,4,4,4,4,4,4,4,4,4,4,4,6,6,6,4,4,4,4,24,
        16,4,4,4,4,4,4,4,4,4,4,4,6,6,6,4,4,4,4,24,
        22,28,28,28,28,28,28,28,28,28,28,28,28,28,28,28,28,28,28,36
    ],
    "decoration": [
        0,0,0,0,0,0,0,0,0,0,0,0,0,0,0,0,0,0,0,0,
        0,0,0,0,0,0,0,0,0,0,0,0,0,0,0,0,0,0,0,0,
        0,0,0,0,0,0,0,0,0,0,0,0,0,0,0,0,0,0,0,0,
        0,0,0,0,0,0,0,0,0,0,0,0,66,0,0,0,0,0,0,0,
        0,0,0,0,0,0,0,0,0,0,0,0,0,0,0,66,0,0,0,0,
        0,0,0,0,66,0,0,0,0,0,0,0,0,0,0,0,0,0,0,0,
        0,0,0,0,0,0,0,64,0,0,64,0,0,66,0,0,0,0,0,0,
        0,0,0,0,0,0,0,0,0,0,0,72,0,0,0,0,0,0,0,0,
        0,0,0,0,0,0,0,0,72,0,0,0,0,0,0,0,0,0,0,0,
        0,0,0,0,0,0,64,0,0,64,0,0,0,0,0,0,0,0,0,0,
        0,0,0,0,0,0,0,0,0,64,0,0,0,0,0,0,0,0,0,0,
        0,0,0,0,0,66,0,0,0,0,0,0,0,0,0,0,0,0,0,0,
        0,0,0,0,0,0,0,0,0,0,0,66,0,0,0,0,0,0,0,0,
        0,0,0,0,0,0,0,0,0,0,0,0,0,66,0,0,0,0,0,0,
        0,0,0,0,0,0,0,0,0,0,0,0,0,0,0,0,0,0,0,0,
        0,0,0,0,0,0,0,0,0,0,0,0,0,0,0,0,0,0,0,0,
        0,0,0,0,0,0,0,0,0,0,0,0,0,0,0,0,0,0,0,0,
        0,0,0,0,0,0,0,0,0,0,0,0,0,0,0,0,0,0,0,0,
        0,0,0,0,0,0,0,0,0,0,0,0,0,0,0,0,0,0,0,0,
        0,0,0,0,0,0,0,0,0,0,0,0,0,0,0,0,0,0,0,0
    ],
    "type": [
        3,3,3,3,3,3,3,3,3,3,3,3,3,3,3,3,3,3,3,3,
        3,0,0,0,0,0,0,0,0,0,0,0,0,0,0,0,0,0,0,3,
        3,0,0,0,0,0,0,0,0,0,0,0,0,0,0,0,0,0,0,3,
        3,0,0,0,0,0,0,0,0,0,0,0,0,0,0,0,0,0,0,3,
        3,0,0,0,0,0,0,0,0,0,0,0,0,0,0,0,0,0,0,3,
        3,0,0,0,0,0,0,0,0,0,0,0,0,0,0,0,0,0,0,3,
        3,0,0,0,0,0,0,0,0,0,0,0,0,0,0,0,0,0,0,3,
        3,0,0,0,0,0,0,0,0,0,0,0,0,0,0,0,0,0,0,3,
        3,0,0,0,0,0,0,0,0,0,0,0,0,0,0,0,0,0,0,3,
        3,0,0,0,0,0,0,0,0,0,0,0,0,0,0,0,0,0,0,3,
        3,0,0,0,0,0,0,0,0,0,0,0,0,0,0,0,0,0,0,3,
        3,0,0,0,0,0,0,0,0,0,0,0,0,0,0,0,0,0,0,3,
        3,0,0,0,0,0,0,0,0,0,0,0,0,0,0,0,0,0,0,3,
        3,0,0,0,0,0,0,0,0,0,0,0,0,0,0,0,0,0,0,3,
        3,0,0,0,0,0,0,0,0,0,0,0,0,0,0,0,0,0,0,3,
        3,0,0,0,0,0,0,0,0,0,0,0,0,0,0,0,0,0,0,3,
        3,0,0,0,0,0,0,0,0,0,0,0,0,0,0,0,0,0,0,3,
        3,0,0,0,0,0,0,0,0,0,0,0,0,0,0,0,0,0,0,3,
        3,0,0,0,0,0,0,0,0,0,0,0,0,0,0,0,0,0,0,3,
        3,3,3,3,3,3,3,3,3,3,3,3,3,3,3,3,3,3,3,3
    ],
    "team": [
        0,0,0,0,0,0,0,0,0,0,0,0,0,0,0,0,0,0,0,0,
        0,0,0,0,0,0,0,0,0,0,0,0,0,0,0,0,0,0,0,0,
        0,0,0,0,0,0,0,0,0,0,0,0,0,0,0,0,0,0,0,0,
        0,0,0,0,0,0,0,0,0,0,0,0,0,0,0,0,0,0,0,0,
        0,0,0,0,0,0,0,0,0,0,0,0,0,0,0,0,0,0,0,0,
        0,0,0,0,0,0,0,0,0,0,0,0,0,0,0,0,0,0,0,0,
        0,0,0,0,0,0,0,0,0,0,0,0,0,0,0,0,0,0,0,0,
        0,0,0,0,0,0,0,0,0,0,0,0,0,0,0,0,0,0,0,0,
        0,0,0,0,0,0,0,0,0,0,0,0,0,0,0,0,0,0,0,0,
        0,0,0,0,0,0,0,0,0,0,0,0,0,0,0,0,0,0,0,0,
        0,0,0,0,0,0,0,0,0,0,0,0,0,0,0,0,0,0,0,0,
        0,0,0,0,0,0,0,0,0,0,0,0,0,0,0,0,0,0,0,0,
        0,0,0,0,0,0,0,0,0,0,0,0,0,0,0,0,0,0,0,0,
        0,0,0,0,0,0,0,0,0,0,0,0,0,0,0,0,0,0,0,0,
        0,0,0,0,0,0,0,0,0,0,0,0,0,0,0,0,0,0,0,0,
        0,0,0,0,0,0,0,0,0,0,0,0,0,0,0,0,0,0,0,0,
        0,0,0,0,0,0,0,0,0,0,0,0,0,0,0,0,0,0,0,0,
        0,0,0,0,0,0,0,0,0,0,0,0,0,0,0,0,0,0,0,0,
        0,0,0,0,0,0,0,0,0,0,0,0,0,0,0,0,0,0,0,0,
        0,0,0,0,0,0,0,0,0,0,0,0,0,0,0,0,0,0,0,0
    ]
}